                         
    ######  ########     
      #######  #         
       #      #####      
     ######      #       
      #  #      ###      
      #  #      # #      
      ######$######      
         #       ####### 
         #            #  
     #############$   #  
      #        #   ####  
      #  ####  #    #    
      #####    ######    
        #        #       
        #####    #       
          #      ##      
                         
