
     #####$#####
    ##        ##
    #          #
    #          #
    ##        ##
     ##########
          #
     ###########
   ###    #    ###
  ##      #      ##
          #
          #
          #
       ######
      ##    ##
     ##      ##
    ##        ##
   ##          ##
